XXXXXXXXXXXX
@  X       X
X  X  XXXXXX
X     XXXXXX
X XX       X
XXXXXXXXXXXX