XXXXXXXXXXXX
@ X        X
X XX  XXXXXX
X     XXXXXX
X XX       X
XXXXXXXXXXXX