XXXXXXXXXXXX
@          X
X     XXXXXX
X XX  XXXXXX
X XX       X
XXXXXXXXXXXX