XXXXXXXXXXXX
@ XX       X
X X   XXXXXX
X     XXXXXX
X XX       X
XXXXXXXXXXXX